1111111111111111111111
1000000000100100100001
1000008000000000000001
1009001000000000000001
1000001000000000000001
1000001000000000000001
1030001000000000000001
1000001000000080000001
1000001000000000000001
1111111110000000000001
1000010000000000009001
1000010000111111111111
1000010000010000010001
1000000700010000010001
1000000000010000010001
1000000000010000010001
1000009000010000000001
1000900000010000000901
1000000000010000010001
1060000008000000010001
1000000000000000010021
1111111111111111111111
