1111111111111111111111
1304010000100010010001
1000010000000010000001
1000010000000010000001
1000010000000010000001
1000010000000010000001
1000010000000010000001
1000010000000010000001
1000010000004010000001
1000000000000000000001
1000004000000000000001
1000000000000004000001
1000000000000000000001
1000000000000000000001
1000000000100000010001
1000000000100000010001
1000000000100000010001
1000000000100000010001
1000000000100000010001
1000000000100000010041
1000000000100000010021
1111111111111111111111
