1111111111111111111111
1301000000100100100001
1041000000000000000001
1001001000400000000001
1401001000000000007001
1001001000000000000001
1041001000000040000001
1000001000000000000001
1000001000000000000001
1111111111110000000001
1000010400000040000001
1000010000111111111111
1000010000010000010001
1000000000010400010001
1000004000010000010401
1000000000010000010001
1000600000010000000001
1000004000010000000001
1000000000010040010001
1000000000000000010041
1000000000000000014021
1111111111111111111111
