1111111111111111111111
1000000000100100100001
1000000000000000000001
1000001000000700009001
1000001000000000000001
1000001000000500000001
1030001000000000000001
1000001000000080000001
1000001000000000000001
1111111110000000000001
1000010000000000000001
1090010000111111111111
1000010000010000010001
1000000000010000010801
1000000000010000010001
1000000000010000010001
1008000000010000000001
1000000000010000000901
1000000000010000010001
1000000008000000010001
1000000000000000010021
1111111111111111111111
